120,41,41,41,41,41,41,41,41,41
30,31,36,31,31,31,31,31,32,41
40,33,42,41,41,43,34,44,42,41
40,41,42,41,41,42,41,40,42,41
55,34,52,41,41,42,120,40,42,41
40,41,41,41,41,53,31,54,42,41
50,51,59,39,51,51,51,51,52,41
65,66,66,66,66,66,66,66,66,67
75,76,76,76,76,76,76,76,76,77
85,86,86,86,86,86,86,86,86,87
